- - - - - 0 0 0 0 0
- - - - - 0 0 0 0 0
- - - - - 0 0 0 0 n
- - - - - 0 0 0 0 0
- - - - - 0 0 0 0 0
- - - - g - n - - -
- - - - - - P - - -
- n - - - - X - - -
- - - - - - - - - -
- - - - - - - - f - 